%%%%%
%P  %
% % % 
%.%.%
% % % 
% % % 
% %G%
% %.%
% % %
%G% %
%%%%%
