%%%%%%%%%%%
%P      G.%
% %   %   %
% % . %.  %
% %%%%%%. %
%   G .%  %
%.       .%
%%%%%%%%%%%
