%%%%%%%%
%P  .  %
% .% . %
%  %%% %
%G.% . %
%.    G%
%%%%%%%%
