%%%%%
%P  %
%.% %
% %.%
% %.%
% %.%
%. G%
%%%%%
